#.#.#.#.#.#
.#.#.#.#.#.
#.#.#.#.#.#
.#.#.#.#.#.
#.#.#.#.#.#
.#.#.#.#.#.
#.#.#.#.#.#
.#.#.#.#.#.
#.#.#.#.#.#
...........
...........
...........
...........
...........
...........
...........
...........
...........
...........
...........
...........
...........
...........
...........
...........
...........
...........
...........
...........
...........
...........
...........