###########
.#.#.#.#.#.
###########
#.#.#.#.#.#
###########
.#.#.#.#.#.
###########
#.#.#.#.#.#
###########
...........
...........
...........
...........
...........
...........
...........
...........
...........
...........
...........
...........
...........
...........
...........
...........
...........
...........
...........
...........
...........
...........
...........